c 13
r 10
-------------
|           |
|--         |
|     --    |
|           |
|           |
|           |
|           |
|           |
-------------#

##############################